5	5
3	2
0	1	2	3	3
0	1	3	2	0
1	2	0	1	1
3	3	2	1	2
2	1	3	0	2
